111111111111111111111111111111111111111111111111111111
111111111111111111111111111111111111111111111111111111
000000000000000000000001000000000000000000000000000001
000000000000000000000000000000000000000000000000000041
111111112221111111111100011111111333111111111111111111
111111111111111111111111111111111111111111111111111111