111111111111111111111111111111111111111111111111111111
111111111111111111111111111111111111111111111111111111
000000000000000000000001000000000000000000000000000011
000000000000000000000001000000000000000000000000000011
000000000000000000000000000000000000000000000000000011
111111112221111111111100011111111333111111111111111011
111111112221111111111100011111111333111111111111111011
111111111111111111111111111111111111111111111111111011
111111111111111111111111111111111111111111111111111011
140000000000000000000000000000000000000000000000000011
140000000000000000000000000000000000000000000000000011
111111111111111111111111111111111111111111111111111111